2 1
7 8
  123456
 #######
1#     #
2# #####
3#   #G#
4# ### #
5# ### #
6#     #
 #######